NO textures/wall_n.png
SO textures/wall_s.png
WE textures/wall_w.png
EA textures/wall_e.png

F 90,96,96
C 51,255,255

    1111111111111111111111111
    1000000000110000000000001
    1011000001110000000000001
100100000000000000000000111111111
111111111011000001110000000000001
100000000011000001110111111111111
11110111111111011100000010001111111111111111
11110111111111011101010010000000000000000001
11000000110101011100000010001111111111111111
10000000000000001100000010001
1000000000000N000001010010001
110000011101010111110111100111
11110111 1110101 101111000001
11111111 1111111 111111111111