F 162,95,53
C 130,184,194

NO textures/image4.png
SO textures/image5.png
WE textures/image6.png
EA textures/image7.png

111111111111
111111111111