F 162,95,53
C 130,184,194

NO textures/image4.png
SO textures/image5.png
WE textures/image6.png
EA textures/image7.png


    1111111111111111111111111
    1000000000110000000000001
    1011000001110000000000001
100100000000000000000000111111111
111111111011000001110000000000001
100000000011000001110111111111111
11110111111111011100000010001
11110011111111011101010010001
11000000110101011100000010001
10000000000000001100000010001
1000000000000N000001010010001
110000011101010111110111100111
11110111 1110101 101111000001
11111111 1111111 111111111111