F 162,95,53
C 130,184,194

NO textures/image4.png
SO textures/image5.png
WE textures/image6.png
EA textures/image7.png

111111111111
1000E0000001
111110000001
100000000001
100000000111
100000000001
111111111111