F 50,50,50

NO textures/image12.png
SO textures/image13.png
WE textures/image14.png
EA textures/image15.png

C 25,51,90

111111111111
1000E0000001
111110000001
111111111111