NO     map.cub
SO map.cub
F    255,255,255


WE map.cub

EA map.cub
C 0,110,255


11111111111111111111111111
1000000000110000000000001
1011000001110000000000001
1001000000010000000000001
111111111011000001110000000000001
100000000011000001110111111111111
11110111111111011100000010001
11110111111111011101010010001
11000000110101011100000010001
10000000000100001100000010001
10000000000100001101010010001
11000000110101011111011110N0111
111101111110101101111010001
111111111111111111111111111