F 173,164,140
C 192,223,239
NO ./assets/image.png
SO ./assets/image1.png
WE ./assets/image2.png
EA ./assets/image3.png

1111111111
1000000001
1000N00001
1000000001
1111111111