F 190,164,140
NO ./assets/image7.png
SO ./assets/image4.png
WE ./assets/image6.png
EA ./assets/image5.png
C 200,223,239

11111111111111111111
111000000000000000011
   1110000001000000000111
111100000000100000000011
110000000000100000000011
1100N0100000000000000011
110000100011111111110000011
110000100000000000000011
1100000000111110000000011
1000000000000000000000011
1111111111   111111111111