F 20,20,30
C 200,200,230
NO ./assets/image8.png
SO ./assets/image9.png
WE ./assets/image10.png
EA ./assets/image11.png

1111111111111111111111
1000000000000000000001
1000000000000000000001
1000000E00000000000001
1000100000000000000001
1000000001111111100001
1000000001      111111
1000000001
100001000111111111111
100001000000000000001
100001000111111111111
1000010001
1000000001      111111
1000000001111111100001
1000100010000000000001
1000000000001111111111
1000000000000000000001
1000000000000000000001
1111111111111111111111